CurvePoint_t	KEYWORD1
TCurve	KEYWORD1
addPoint	KEYWORD2
dump	KEYWORD2
dumpCurvePoint	KEYWORD2
getName	KEYWORD2
getNbPoints	KEYWORD2
getPoint	KEYWORD2
getSetpoint	KEYWORD2
getWeekPattern	KEYWORD2
isApplicableForDay	KEYWORD2
newCurvePoint	KEYWORD2
removeAllPoints	KEYWORD2
setApplicableForDay	KEYWORD2
setName	KEYWORD2
setWeekPattern	KEYWORD2
TProgram	KEYWORD1
addCurve	KEYWORD2
getCurve	KEYWORD2
getCurveForDay	KEYWORD2
getName	KEYWORD2
getNbCurves	KEYWORD2
getSetpoint	KEYWORD2
removeAllCurves	KEYWORD2
removeCurve	KEYWORD2
setName	KEYWORD2
